12 18
000000000000000000
000211000000211000
000111000000211000
000111000000211000
000111000000211000
000111000000211000
000030000000211000
011111111111211000
011111220011111220
011111110011111220
011111110011111220
000000000000000000
3 10 4 10 5 10 4 9
6
archer 3 1 0 1 1
archer 4 1 2 2 2
archer 5 1 0 1 1
guard 3 7 0 1 1
guard 4 7 1 1 2
guard 5 7 0 1 1
